_ _ _ _ _ _ _ _ _ _ _ _ _ _ _ _ _ _ _ _ _ 
_ _ _ _ _ _ _ _ _ _ _ _ _ _ _ _ _ _ _ _ _ 
_ B _ _ _ _ _ _ _ _ _ _ _ _ _ _ _ _ _ _ _ 
_ _ _ _ _ _ _ _ _ _ _ _ _ _ _ _ _ _ _ _ _ 
_ _ _ _ _ _ _ _ _ _ _ _ _ _ _ _ _ _ _ _ _ 
_ _ _ _ _ _ _ _ 1 _ _ _ _ _ _ _ _ _ _ _ _ 
_ _ _ _ _ _ _ _ _ _ _ _ _ _ _ _ _ _ _ _ _ 
_ _ _ g _ g c _ _ _ _ _ _ _ _ _ _ _ _ _ _ 
_ _ _ _ _ _ _ _ _ _ _ _ _ _ _ _ _ _ _ _ _ 
_ _ _ _ _ X _ _ _ _ _ _ _ _ _ _ _ _ _ _ _ 
_ _ _ X X X X X c X X X X _ _ _ _ _ _ _ _ 
_ _ _ X _ _ X _ _ _ _ X _ _ _ _ _ _ _ _ _ 
_ _ _ X _ _ X _ _ _ _ _ _ _ _ _ _ _ _ _ _ 
_ _ _ X X X X _ _ _ _ _ _ _ _ _ _ _ _ _ _ 
_ _ _ _ _ X _ _ _ _ _ _ _ _ _ _ _ _ _ _ _ 
_ _ _ _ _ X _ _ _ _ _ _ _ _ _ c _ _ _ _ _ 
_ _ _ _ _ _ _ _ _ _ _ _ _ _ _ _ _ _ _ _ _ 
_ _ _ _ _ _ _ _ _ _ _ _ X X X _ _ _ 2 _ _ 
_ _ _ _ _ _ _ _ _ _ _ _ X n X X X _ _ _ _ 
_ _ _ _ _ _ _ _ _ _ _ _ X _ _ _ _ _ _ _ _ 
_ _ _ _ _ _ _ _ _ _ _ _ _ _ _ _ _ _ _ _ _ 
