c c c c c c c _ _ _ c c c _ _ _ i _ j X X 
c X X c X X c _ _ _ c c c _ _ h _ g X X X 
c X X c X X c X X X X X X X X X X X X X p 
c c c c c c c X _ _ _ _ _ _ _ _ _ X X m _ 
X X X c X X X X c c c c c c c c c _ X _ o 
c c c c X 2 _ _ _ _ _ _ _ _ c X c _ X n _ 
c X _ c X c c c c _ c c c c c c c _ X _ _ 
c _ _ c X c _ _ _ _ _ _ _ X c _ c _ X _ _ 
c c c c c c c c c _ c c c _ c _ c _ X c c 
X X X X X X X X c _ c X c _ c _ c _ X c c 
c c c c c c c c c _ c c c _ c _ c _ X c c 
_ _ _ _ _ _ _ _ c _ _ _ _ _ _ _ c _ X _ _ 
_ c c c c c c c c c c c c _ c _ c _ X _ _ 
_ c X X X X X X c _ c X c _ c _ X X X _ _ 
_ c c c c c c X c _ c X c _ c _ X c c c c 
_ _ _ _ _ _ c X c _ c X c c c 1 X c X X c 
X X X _ _ _ c X c _ c X c X X X X c X X c 
_ _ _ _ _ _ c X c _ c X c c c c c c c c c 
_ _ _ _ X _ c X c _ c X c _ _ c X c X X c 
_ _ _ _ X _ c c c _ c X c _ X c X c X X c 
B _ _ _ X _ _ _ _ _ c X c c c c X c c c c 
