c c c c c c c _ _ _ _ _ _ _ c g X X X X X 
c X X c _ _ _ _ _ _ X X _ _ c h X c c c X 
c X X c _ _ _ _ _ _ X X _ _ c j X c X c X 
c c c c c c c c _ _ _ _ _ _ c i X c c c X 
X X X c X X X X X X X X X X X X X X X X X 
c c c c X 2 _ _ _ _ _ _ _ _ _ _ X o p n m 
c X _ c X c c c c c c c c c c _ X c c c c 
c _ _ c X c _ _ _ _ _ _ _ X c _ X _ _ _ _ 
c c c c c c c c c _ c c c _ c _ X _ _ _ _ 
X X X X X X X X c _ c X c _ c _ X _ X X _ 
c c c c c c c c c _ c c c _ c _ X _ X X _ 
_ _ _ _ _ _ _ _ c _ _ _ _ _ c _ X _ _ _ _ 
_ c c c c c c c c c c c c _ c _ X _ _ _ _ 
_ c X X X X X X c _ c X c _ c _ X c _ _ _ 
_ c c c c c c X c _ c X c _ c _ X c _ _ c 
_ _ _ _ _ _ c X c _ c X c c c 1 X c _ _ c 
X X X _ _ _ c X c _ c X c X X X X c _ _ c 
_ _ _ _ _ _ c X c _ c X c c c c c c c c c 
_ _ _ _ X _ c X c _ c X c _ _ c X c X X c 
_ _ _ _ X _ c c c _ c X c _ X c X c X X c 
B _ _ _ X _ _ _ _ _ c X c c c c X c c c c 
