_ _ _ _ _ _ _ _ _ _ c _ _ _ _ _ _ _ _ _ _ 
_ _ _ _ _ _ _ _ _ _ X _ _ _ _ _ _ _ _ _ _ 
_ _ h c _ _ _ _ _ _ _ _ _ _ _ _ _ c _ _ _ 
_ _ c X _ _ _ _ _ _ _ _ _ _ _ _ _ X c _ _ 
_ _ _ _ _ c _ _ _ _ _ _ _ _ _ c _ _ _ _ _ 
_ _ _ _ c X _ _ X c _ c X _ _ X c _ _ _ _ 
_ _ _ _ _ _ _ _ X c _ c X _ _ _ _ _ _ _ _ 
_ _ _ _ _ _ _ _ X X _ X X _ _ _ _ _ _ _ _ 
_ _ _ _ _ X X X c c c c c X X X _ _ _ _ _ 
_ _ _ _ _ c c X c _ _ _ c X c c _ _ _ _ _ 
c X _ _ _ _ _ _ c _ B _ c _ _ _ _ _ _ X c 
_ _ _ _ _ c c X c _ _ _ c X c c _ _ _ _ _ 
_ _ _ _ _ X X X c c c c c X X X _ _ _ _ _ 
_ _ _ _ _ _ _ _ X X _ X X _ _ _ _ _ _ _ _ 
_ _ _ _ _ _ _ _ X c _ c X _ _ _ _ _ _ _ _ 
_ _ _ _ c X _ _ X c _ c X _ _ X c _ _ _ _ 
_ _ _ _ _ c _ _ _ _ _ _ _ _ _ c _ _ _ _ _ 
_ _ c X _ _ _ _ _ _ _ _ _ _ _ _ _ X c _ _ 
_ _ _ c _ _ _ _ _ _ _ _ _ _ _ _ _ c n _ _ 
_ _ _ _ _ _ _ _ _ _ X _ _ _ _ _ _ _ _ _ _ 
_ _ _ _ _ _ _ _ _ _ c _ _ _ _ _ _ _ _ _ _ 
